  ##############
  #            ##
  # X   X  ###  #
  # #####    #X #
  # #   # X  #  #
  # #   ### ##  #
### #   ##  ##X##
#OO ## ##   ##  #
#OO  # #    ##  #
#OO  # #   ###X #
#OO P# ##  X    #
###### ##  X    #
        # X  # ##
        ###    #
          ######
