 #######
 #     #
 #O##  ##
## ## X #
# X  XX #
# OOO # #
#  #### #
# P     #
#########
